type octile
height 17
width 20
map
....................
.rrrrrrrr..rrrrrrrr.
.rrrrrrrr..rrrrrrrr.
....................
....................
.rr.eeeee..eeeee.rr.
.rr.@@@@@..@@@@@.rr.
.rr.eeeee..eeeee.rr.
....................
.rr.eeeee..eeeee.rr.
.rr.@@@@@..@@@@@.rr.
.rr.eeeee..eeeee.rr.
....................
....................
.rrrrrrrr..rrrrrrrr.
.rrrrrrrr..rrrrrrrr.
....................