type octile
height 33
width 36
map
....................................
..eeeeeeeeee.eeeeeeeeee.eeeeeeeeee..
..@@@@@@@@@@.@@@@@@@@@@.@@@@@@@@@@..
..eeeeeeeeee.eeeeeeeeee.eeeeeeeeee..
....................................
..eeeeeeeeee.eeeeeeeeee.eeeeeeeeee..
..@@@@@@@@@@.@@@@@@@@@@.@@@@@@@@@@..
..eeeeeeeeee.eeeeeeeeee.eeeeeeeeee..
....................................
..eeeeeeeeee.eeeeeeeeee.eeeeeeeeee..
..@@@@@@@@@@.@@@@@@@@@@.@@@@@@@@@@..
..eeeeeeeeee.eeeeeeeeee.eeeeeeeeee..
....................................
..eeeeeeeeee.eeeeeeeeee.eeeeeeeeee..
..@@@@@@@@@@.@@@@@@@@@@.@@@@@@@@@@..
..eeeeeeeeee.eeeeeeeeee.eeeeeeeeee..
....................................
..eeeeeeeeee.eeeeeeeeee.eeeeeeeeee..
..@@@@@@@@@@.@@@@@@@@@@.@@@@@@@@@@..
..eeeeeeeeee.eeeeeeeeee.eeeeeeeeee..
....................................
..eeeeeeeeee.eeeeeeeeee.eeeeeeeeee..
..@@@@@@@@@@.@@@@@@@@@@.@@@@@@@@@@..
..eeeeeeeeee.eeeeeeeeee.eeeeeeeeee..
....................................
..eeeeeeeeee.eeeeeeeeee.eeeeeeeeee..
..@@@@@@@@@@.@@@@@@@@@@.@@@@@@@@@@..
..eeeeeeeeee.eeeeeeeeee.eeeeeeeeee..
....................................
..eeeeeeeeee.eeeeeeeeee.eeeeeeeeee..
..@@@@@@@@@@.@@@@@@@@@@.@@@@@@@@@@..
..eeeeeeeeee.eeeeeeeeee.eeeeeeeeee..
....................................