type octile
height 33
width 36
map
....................................
w.eeeeeeeeee.eeeeeeeeee.eeeeeeeeee.w
..@@@@@@@@@@.@@@@@@@@@@.@@@@@@@@@@..
..eeeeeeeeee.eeeeeeeeee.eeeeeeeeee..
w..................................w
..eeeeeeeeee.eeeeeeeeee.eeeeeeeeee..
..@@@@@@@@@@.@@@@@@@@@@.@@@@@@@@@@..
w.eeeeeeeeee.eeeeeeeeee.eeeeeeeeee.w
....................................
..eeeeeeeeee.eeeeeeeeee.eeeeeeeeee..
w.@@@@@@@@@@.@@@@@@@@@@.@@@@@@@@@@.w
..eeeeeeeeee.eeeeeeeeee.eeeeeeeeee..
....................................
w.eeeeeeeeee.eeeeeeeeee.eeeeeeeeee.w
..@@@@@@@@@@.@@@@@@@@@@.@@@@@@@@@@..
..eeeeeeeeee.eeeeeeeeee.eeeeeeeeee..
w..................................w
..eeeeeeeeee.eeeeeeeeee.eeeeeeeeee..
..@@@@@@@@@@.@@@@@@@@@@.@@@@@@@@@@..
w.eeeeeeeeee.eeeeeeeeee.eeeeeeeeee.w
....................................
..eeeeeeeeee.eeeeeeeeee.eeeeeeeeee..
w.@@@@@@@@@@.@@@@@@@@@@.@@@@@@@@@@.w
..eeeeeeeeee.eeeeeeeeee.eeeeeeeeee..
....................................
w.eeeeeeeeee.eeeeeeeeee.eeeeeeeeee.w
..@@@@@@@@@@.@@@@@@@@@@.@@@@@@@@@@..
..eeeeeeeeee.eeeeeeeeee.eeeeeeeeee..
w..................................w
..eeeeeeeeee.eeeeeeeeee.eeeeeeeeee..
..@@@@@@@@@@.@@@@@@@@@@.@@@@@@@@@@..
w.eeeeeeeeee.eeeeeeeeee.eeeeeeeeee.w
....................................