type octile
height 45
width 47
map
...............................................
..eeeeeeeeee.eeeeeeeeee.eeeeeeeeee.eeeeeeeeee..
..@@@@@@@@@@.@@@@@@@@@@.@@@@@@@@@@.@@@@@@@@@@..
..eeeeeeeeee.eeeeeeeeee.eeeeeeeeee.eeeeeeeeee..
...............................................
..eeeeeeeeee.eeeeeeeeee.eeeeeeeeee.eeeeeeeeee..
..@@@@@@@@@@.@@@@@@@@@@.@@@@@@@@@@.@@@@@@@@@@..
..eeeeeeeeee.eeeeeeeeee.eeeeeeeeee.eeeeeeeeee..
...............................................
..eeeeeeeeee.eeeeeeeeee.eeeeeeeeee.eeeeeeeeee..
..@@@@@@@@@@.@@@@@@@@@@.@@@@@@@@@@.@@@@@@@@@@..
..eeeeeeeeee.eeeeeeeeee.eeeeeeeeee.eeeeeeeeee..
...............................................
..eeeeeeeeee.eeeeeeeeee.eeeeeeeeee.eeeeeeeeee..
..@@@@@@@@@@.@@@@@@@@@@.@@@@@@@@@@.@@@@@@@@@@..
..eeeeeeeeee.eeeeeeeeee.eeeeeeeeee.eeeeeeeeee..
...............................................
..eeeeeeeeee.eeeeeeeeee.eeeeeeeeee.eeeeeeeeee..
..@@@@@@@@@@.@@@@@@@@@@.@@@@@@@@@@.@@@@@@@@@@..
..eeeeeeeeee.eeeeeeeeee.eeeeeeeeee.eeeeeeeeee..
...............................................
..eeeeeeeeee.eeeeeeeeee.eeeeeeeeee.eeeeeeeeee..
..@@@@@@@@@@.@@@@@@@@@@.@@@@@@@@@@.@@@@@@@@@@..
..eeeeeeeeee.eeeeeeeeee.eeeeeeeeee.eeeeeeeeee..
...............................................
..eeeeeeeeee.eeeeeeeeee.eeeeeeeeee.eeeeeeeeee..
..@@@@@@@@@@.@@@@@@@@@@.@@@@@@@@@@.@@@@@@@@@@..
..eeeeeeeeee.eeeeeeeeee.eeeeeeeeee.eeeeeeeeee..
...............................................
..eeeeeeeeee.eeeeeeeeee.eeeeeeeeee.eeeeeeeeee..
..@@@@@@@@@@.@@@@@@@@@@.@@@@@@@@@@.@@@@@@@@@@..
..eeeeeeeeee.eeeeeeeeee.eeeeeeeeee.eeeeeeeeee..
...............................................
..eeeeeeeeee.eeeeeeeeee.eeeeeeeeee.eeeeeeeeee..
..@@@@@@@@@@.@@@@@@@@@@.@@@@@@@@@@.@@@@@@@@@@..
..eeeeeeeeee.eeeeeeeeee.eeeeeeeeee.eeeeeeeeee..
...............................................
..eeeeeeeeee.eeeeeeeeee.eeeeeeeeee.eeeeeeeeee..
..@@@@@@@@@@.@@@@@@@@@@.@@@@@@@@@@.@@@@@@@@@@..
..eeeeeeeeee.eeeeeeeeee.eeeeeeeeee.eeeeeeeeee..
...............................................
..eeeeeeeeee.eeeeeeeeee.eeeeeeeeee.eeeeeeeeee..
..@@@@@@@@@@.@@@@@@@@@@.@@@@@@@@@@.@@@@@@@@@@..
..eeeeeeeeee.eeeeeeeeee.eeeeeeeeee.eeeeeeeeee..
...............................................