type octile
height 45
width 47
map
...............................................
w.eeeeeeeeee.eeeeeeeeee.eeeeeeeeee.eeeeeeeeee.w
..@@@@@@@@@@.@@@@@@@@@@.@@@@@@@@@@.@@@@@@@@@@..
..eeeeeeeeee.eeeeeeeeee.eeeeeeeeee.eeeeeeeeee..
w.............................................w
..eeeeeeeeee.eeeeeeeeee.eeeeeeeeee.eeeeeeeeee..
..@@@@@@@@@@.@@@@@@@@@@.@@@@@@@@@@.@@@@@@@@@@..
w.eeeeeeeeee.eeeeeeeeee.eeeeeeeeee.eeeeeeeeee.w
...............................................
..eeeeeeeeee.eeeeeeeeee.eeeeeeeeee.eeeeeeeeee..
w.@@@@@@@@@@.@@@@@@@@@@.@@@@@@@@@@.@@@@@@@@@@.w
..eeeeeeeeee.eeeeeeeeee.eeeeeeeeee.eeeeeeeeee..
...............................................
w.eeeeeeeeee.eeeeeeeeee.eeeeeeeeee.eeeeeeeeee.w
..@@@@@@@@@@.@@@@@@@@@@.@@@@@@@@@@.@@@@@@@@@@..
..eeeeeeeeee.eeeeeeeeee.eeeeeeeeee.eeeeeeeeee..
w.............................................w
..eeeeeeeeee.eeeeeeeeee.eeeeeeeeee.eeeeeeeeee..
..@@@@@@@@@@.@@@@@@@@@@.@@@@@@@@@@.@@@@@@@@@@..
w.eeeeeeeeee.eeeeeeeeee.eeeeeeeeee.eeeeeeeeee.w
...............................................
..eeeeeeeeee.eeeeeeeeee.eeeeeeeeee.eeeeeeeeee..
w.@@@@@@@@@@.@@@@@@@@@@.@@@@@@@@@@.@@@@@@@@@@.w
..eeeeeeeeee.eeeeeeeeee.eeeeeeeeee.eeeeeeeeee..
...............................................
w.eeeeeeeeee.eeeeeeeeee.eeeeeeeeee.eeeeeeeeee.w
..@@@@@@@@@@.@@@@@@@@@@.@@@@@@@@@@.@@@@@@@@@@..
..eeeeeeeeee.eeeeeeeeee.eeeeeeeeee.eeeeeeeeee..
w.............................................w
..eeeeeeeeee.eeeeeeeeee.eeeeeeeeee.eeeeeeeeee..
..@@@@@@@@@@.@@@@@@@@@@.@@@@@@@@@@.@@@@@@@@@@..
w.eeeeeeeeee.eeeeeeeeee.eeeeeeeeee.eeeeeeeeee.w
...............................................
..eeeeeeeeee.eeeeeeeeee.eeeeeeeeee.eeeeeeeeee..
w.@@@@@@@@@@.@@@@@@@@@@.@@@@@@@@@@.@@@@@@@@@@.w
..eeeeeeeeee.eeeeeeeeee.eeeeeeeeee.eeeeeeeeee..
...............................................
w.eeeeeeeeee.eeeeeeeeee.eeeeeeeeee.eeeeeeeeee.w
..@@@@@@@@@@.@@@@@@@@@@.@@@@@@@@@@.@@@@@@@@@@..
..eeeeeeeeee.eeeeeeeeee.eeeeeeeeee.eeeeeeeeee..
w.............................................w
..eeeeeeeeee.eeeeeeeeee.eeeeeeeeee.eeeeeeeeee..
..@@@@@@@@@@.@@@@@@@@@@.@@@@@@@@@@.@@@@@@@@@@..
w.eeeeeeeeee.eeeeeeeeee.eeeeeeeeee.eeeeeeeeee.w
...............................................